1111000001111
1000000000001
1000000000001
1000000000001
0000000000001
0000000000001
0000000000001
0000000000001
0000000000001
1000000000001
1000000000001
1000000000001
1111000001111